5 10
|--------|
|.F.|..-.|
|..-|.@..|
|......-.|
|--------|